Acadia - beaches, Mountains, islands 
Arches - desert, unique rock formations
Badlands - prarie, badlands
Big Bend - desert, mountains, canyons 
Biscayne - coast, beaches, islands
Black Canyon Gunnison - canyon, river
Bryce Canyon - desert, unique rock formations
Canyonlands - desert, canyons, unique rock formations
Capitol Reef - desert, canyons,  unique rock formations
Carlsbad - caverns/caves
Channel Islands - coast, beaches, islands
Congaree - old-growth forest, swamp
Crater Lake - ancient volcano, lake, 
Cuyahoga Valley - forest, river
Death valley, - desert, sand dunes, canyons,
Denali - mountains, glaciers
Dry Tortugas - islands, coast, beaches
Everglades - swamp, wetlands, forest
Gates of the Artic - Mountains
Glacier - Mountains, glaciers, 
Glacier Bay - Glaciers, mountains, fjords, rainforest
Grand Canyon - river, canyon, desert
Grand Teton - mountains, plains, lakes
Great Basin - mountain, caves, desert
Great Sand Dunes - desert, sand dunes
Great Smokey Mountains - monutians, forest, 
Guadelupe Peak - mountains, desert
Haleakala - mountain, volcano
Hawaii volcanoes - volcanoes, islands
Hot Springs - forest, geothermals, montains
Isle Royal - lakes, island, beaches
Joshua Tree - desert, unique plants, snad dunes,
Katmai - rivers, mountains, volcano
Kenai Fjords - fjords, glaciers
Kings Canyon - canoyno, unique plants, 
Kobuk Valley - river, snad dunes
Lake Clark - lake, volcanoes, glaciers, mountains
Lassed Volcanic - volcanoes, geothermals
Mammoth Cave - caves
Mesa Verde - mountains, ancient ruins
Mount Rainer - montains, volcano, glaciers
North Cascades - lake, mountains
Olympic- rainforest, montains, 
Petrified Foest - desert, unique rock features
Pinnacles - caves, monutains
Redwood - unqie trees, rivers, forest
Rocky Mountain - mountains
Saguaro - mouintains, desert, unique plant features
Sequoia - forest, caves, mountains
Shenandoah - forest, river
Theodore Roosevelt - badlands
Voyageurs - lakes, beaches, islands
Wind Cave - caves
Wrangell - St. Elias - monitains, volcanoes, glaciers
Yellowstone - geothermal, plains, canyon, mountains, 
Yosemite - mountains, unique rock formations, forest
Zion - desert, unique rock formations, cnayons, forest
